{
    "title": "さしすせそ",
    "pre": [3],
    "content": [
        "さしすせそ",
        "さしすせそ",
        "さしすせそ",
        "さしすせそ",
        "さしすせそ",
        "さしすせそ",
        "さしすせそ",
        "さしすせそ",
        "さしすせそ",
        "さしすせそ",

        "サシスセソ",
        "サシスセソ",
        "サシスセソ",
        "サシスセソ",
        "サシスセソ",
        "サシスセソ",
        "サシスセソ",
        "サシスセソ",
        "サシスセソ",
        "サシスセソ",

        "あいうえお",
        "あいうえお",
        "あいうえお",
        "アイウエオ",
        "アイウエオ",
        "アイウエオ",

        "さしすせそ",
        "さしすせそ",
        "さしすせそ",
        "さしすせそ",
        "さしすせそ",
        "さしすせそ",
        "さしすせそ",
        "さしすせそ",
        "さしすせそ",
        "さしすせそ",

        "サシスセソ",
        "サシスセソ",
        "サシスセソ",
        "サシスセソ",
        "サシスセソ",
        "サシスセソ",
        "サシスセソ",
        "サシスセソ",
        "サシスセソ",
        "サシスセソ",

        {
            "type": "test",
            "content": "さしすせそ"
        },
        "さしすせそ",
        "さしすせそ",
        "さしすせそ",
        "さしすせそ",
        "サシスセソ",
        "サシスセソ",
        "サシスセソ",
        "サシスセソ",
        "サシスセソ"
    ]
}