{
    "title": "たちつてと",
    "pre": [3],
    "content": [
        "たちつてと",
        "たちつてと",
        "たちつてと",
        "たちつてと",
        "たちつてと",
        "たちつてと",
        "たちつてと",
        "たちつてと",
        "たちつてと",
        "たちつてと",

        "タチツテト",
        "タチツテト",
        "タチツテト",
        "タチツテト",
        "タチツテト",
        "タチツテト",
        "タチツテト",
        "タチツテト",
        "タチツテト",
        "タチツテト",

        "かきくけこ",
        "かきくけこ",
        "かきくけこ",
        "カキクケコ",
        "カキクケコ",
        "カキクケコ",

        "たちつてと",
        "たちつてと",
        "たちつてと",
        "たちつてと",
        "たちつてと",
        "たちつてと",
        "たちつてと",
        "たちつてと",
        "たちつてと",
        "たちつてと",

        "タチツテト",
        "タチツテト",
        "タチツテト",
        "タチツテト",
        "タチツテト",
        "タチツテト",
        "タチツテト",
        "タチツテト",
        "タチツテト",
        "タチツテト",

        {
            "type": "test",
            "content": "たちつてと"
        },
        "たちつてと",
        "たちつてと",
        "たちつてと",
        "たちつてと",
        "タチツテト",
        "タチツテト",
        "タチツテト",
        "タチツテト",
        "タチツテト"
    ]
}