{
    "title": "テスト２",
    "pre": [4, 5],
    "content": [
        "さしすせそ",
        "サシスセソ",
        "たちつてと",
        "タチツテト",

        {
            "type": "test",
            "content": "さしすせそ"
        },
        "サシスセソ",
        "たちつてと",
        "タチツテト",

        "さたしちすつせてそと",
        "さたしちすつせてそと",
        "さたしちすつせてそと",
        "あかいきうくえけおこ",
        "あかいきうくえけおこ",
        "あかいきうくえけおこ",
        "さたしちすつせてそと",
        "さたしちすつせてそと",
        "さたしちすつせてそと",
        "さたしちすつせてそと",
        "さたしちすつせてそと",
        "さたしちすつせてそと",
        "さたしちすつせてそと",

        "サタシチスツセテソト",
        "サタシチスツセテソト",
        "サタシチスツセテソト",
        "アカイキウクエケオコ",
        "アカイキウクエケオコ",
        "アカイキウクエケオコ",
        "サタシチスツセテソト",
        "サタシチスツセテソト",
        "サタシチスツセテソト",
        "サタシチスツセテソト",
        "サタシチスツセテソト",
        "サタシチスツセテソト",
        "サタシチスツセテソト"
    ]
}