{
    "title": "なにぬねの",
    "pre": [6],
    "content": [
        "なにぬねの",
        "なにぬねの",
        "なにぬねの",
        "なにぬねの",
        "なにぬねの",
        "なにぬねの",
        "なにぬねの",
        "なにぬねの",
        "なにぬねの",
        "なにぬねの",

        "ナニヌネノ",
        "ナニヌネノ",
        "ナニヌネノ",
        "ナニヌネノ",
        "ナニヌネノ",
        "ナニヌネノ",
        "ナニヌネノ",
        "ナニヌネノ",
        "ナニヌネノ",
        "ナニヌネノ",

        "あいうえお",
        "あいうえお",
        "あいうえお",
        "アイウエオ",
        "アイウエオ",
        "アイウエオ",
        
        "かきくけこ",
        "かきくけこ",
        "かきくけこ",
        "カキクケコ",
        "カキクケコ",
        "カキクケコ",

        "なにぬねの",
        "なにぬねの",
        "なにぬねの",
        "なにぬねの",
        "なにぬねの",
        "なにぬねの",
        "なにぬねの",
        "なにぬねの",
        "なにぬねの",
        "なにぬねの",

        "ナニヌネノ",
        "ナニヌネノ",
        "ナニヌネノ",
        "ナニヌネノ",
        "ナニヌネノ",
        "ナニヌネノ",
        "ナニヌネノ",
        "ナニヌネノ",
        "ナニヌネノ",
        "ナニヌネノ",

        {
            "type": "test",
            "content": "なにぬねの"
        },
        "なにぬねの",
        "なにぬねの",
        "なにぬねの",
        "なにぬねの",
        "ナニヌネノ",
        "ナニヌネノ",
        "ナニヌネノ",
        "ナニヌネノ",
        "ナニヌネノ"
    ]
}