{
    "title": "はひふへほ",
    "pre": [6],
    "content": [
        "はひふへほ",
        "はひふへほ",
        "はひふへほ",
        "はひふへほ",
        "はひふへほ",
        "はひふへほ",
        "はひふへほ",
        "はひふへほ",
        "はひふへほ",
        "はひふへほ",

        "ハヒフヘホ",
        "ハヒフヘホ",
        "ハヒフヘホ",
        "ハヒフヘホ",
        "ハヒフヘホ",
        "ハヒフヘホ",
        "ハヒフヘホ",
        "ハヒフヘホ",
        "ハヒフヘホ",
        "ハヒフヘホ",

        "さしすせそ",
        "さしすせそ",
        "さしすせそ",
        "サシスセソ",
        "サシスセソ",
        "サシスセソ",

        "たちつてと",
        "たちつてと",
        "たちつてと",
        "タチツテト",
        "タチツテト",
        "タチツテト",

        "はひふへほ",
        "はひふへほ",
        "はひふへほ",
        "はひふへほ",
        "はひふへほ",
        "はひふへほ",
        "はひふへほ",
        "はひふへほ",
        "はひふへほ",
        "はひふへほ",

        "ハヒフヘホ",
        "ハヒフヘホ",
        "ハヒフヘホ",
        "ハヒフヘホ",
        "ハヒフヘホ",
        "ハヒフヘホ",
        "ハヒフヘホ",
        "ハヒフヘホ",
        "ハヒフヘホ",
        "ハヒフヘホ",

        {
            "type": "test",
            "content": "はひふへほ"
        },
        "はひふへほ",
        "はひふへほ",
        "はひふへほ",
        "はひふへほ",
        "ハヒフヘホ",
        "ハヒフヘホ",
        "ハヒフヘホ",
        "ハヒフヘホ",
        "ハヒフヘホ"
    ]
}