{
    "title": "テスト３",
    "pre": [7, 8],
    "content": [
        "なにぬねの",
        "ナニヌネノ",
        "はひふへほ",
        "ハヒフヘホ",

        {
            "type": "test",
            "content": "なにぬねの"
        },
        "ナニヌネノ",
        "はひふへほ",
        "ハヒフヘホ",

        "なはにひぬふねへのほ",
        "なはにひぬふねへのほ",
        "なはにひぬふねへのほ",

        "あかいきうくえけおこ",
        "あかいきうくえけおこ",
        "あかいきうくえけおこ",
        
        "さたしちすつせてそと",
        "さたしちすつせてそと",
        "さたしちすつせてそと",
        
        "なはにひぬふねへのほ",
        "なはにひぬふねへのほ",
        "なはにひぬふねへのほ",
        "なはにひぬふねへのほ",
        "なはにひぬふねへのほ",
        "なはにひぬふねへのほ",
        "なはにひぬふねへのほ",

        "ナハニヒヌフネヘノホ",
        "ナハニヒヌフネヘノホ",
        "ナハニヒヌフネヘノホ",

        "アカイキウクエケオコ",
        "アカイキウクエケオコ",
        "アカイキウクエケオコ",
        
        "サタシチスツセテソト",
        "サタシチスツセテソト",
        "サタシチスツセテソト",

        "ナハニヒヌフネヘノホ",
        "ナハニヒヌフネヘノホ",
        "ナハニヒヌフネヘノホ",
        "ナハニヒヌフネヘノホ",
        "ナハニヒヌフネヘノホ",
        "ナハニヒヌフネヘノホ",
        "ナハニヒヌフネヘノホ"
    ]
}